10
1111111111
1200300021
1011111101
1055511101
1011555501
1011111101
1200000001
1111115111
1400000001
1111111111