10
1111111111
1210010001
1000000101
1011111101
1000000001
1110111101
1310104111
1010101101
1000000001
1111111111