10
1111111111
1210010021
1000000101
1011111101
1000000001
1110111101
1210104111
1010101121
1000000001
1111111111