25
1111111111111111111111111
1000000000010000000000001
1011111111110111111111101
1010000000010155550011101
1010101111010120000010001
1010101531011151111010101
1010101001000000101010101
1010101001111110101010101
1010101550000000101010101
1110101111111111101010101
1010100000000000001010101
1010111111111111111010101
1010000000002000000000101
1011111111111111111110101
1010000000000000000000101
1010111111101111111011101
1010001000101110001010111
1000100010001010001010001
1011111111111010000011101
1000000000000011111010001
1111111111111110001010111
1000001111111110100010001
1011101000100010110511101
1402100010001000100000021
1111111111111111111111111