10
1111111111
1200300021
1011111101
1051111101
1011111501
1011111101
1000000001
1111115111
1400000001
1111111111