25
1111111111111111111111111
1000000000010000000000001
1011111111110111111111101
1010000000010155550010101
1010000000010120000010501
1010000000011151111510101
1010000000000000001010101
1010000000000000001010101
1010000000000000001010101
1110000000003000001010101
1010000000000000001010101
1010000000000000001010101
1010000000000000001000101
1011111111111111111110101
1010000000000000000010101
1010000000000000000010101
1010000000000000000010101
1010000000000000000010101
1010000000000000000010101
1010000000000000000010101
1011111111111111111110101
1000000000000000000000101
1111111111111111111111101
1204000000000000000000001
1111111111111111111111111