20
11111111111111111111
10000002000000000021
10200000005000000001
10001111111111100001
10001111555111151111
15001200000000121111
15001011111110101111
15001012000010105111
10001050111010105111
10001010145010105111
12001010111010101111
10001010000010101111
10001011111110501111
10051000000002101111
10051111111111111111
11151550000200000031
10001500000000000051
10001000000000000051
12005002005550000051
11111111111111111111