20
11111111111111111111
12100100200000000001
10000001001111111101
10111111010000000001
10000000010011111111
11101111010011111001
12101041110011111001
10101011210000000001
10000000010000000001
10000000000000000001
10000000011100000001
10000000000000000001
10000000000000000001
10000000000000000001
10000000000000000001
10000000000000000001
10000000000000000001
10000000000000000001
10000000000000000001
11111111111111111111